10;10;10;10;10;10;10;10;10;10;10;10;10;10;10;10
1a;0;0;0;0;0;0;0;0;0;0;0;0;0;1a
1;0;0;0;0;0;0;0;0;0;0;0;0;0;1
1;0;0;0;0;0;0;0;0;0;0;0;0;0;1
1;0;0;0;0;0;0;0;0;0;0;0;0;0;1
1;0;0;0;0;0;4d;0;0;0;0;0;0;0;1
1;0;0;0;0;0;0;5a;0;0;0;0;0;0;1
1;0;0;0;0;0;0;0;0;0;0;0;0;0;1
1;0;0;0;0;0;0;0;0;0;0;0;0;0;1
1;1;1;1;1;1;1;1;1;1;1;1;1;1;1
$;0;0;0;0;PIZZA;;;;;;;;;